####################
#..................#
#..T...............#
#..................#
#.........#####....#
#.........#...#....#
#.........#.S.#....#
#.........#...#....#
#.........#####....#
#..................#
#............T.....#
#..................#
####################
